1 1 1 1 1 1 1 1 1 1 1 1
1 0 0 A 0 0 0 0 A 0 0 1
1 0 0 A 0 0 0 0 A 0 0 1
1 0 0 1 1 1 1 1 1 0 0 1
1 0 0 0 E E E 0 0 0 0 1
1 0 1 1 0 0 0 0 1 1 0 1
1 0 A 0 E E E 0 0 A 0 1
1 1 1 1 1 1 1 1 1 1 1 1